11111111111111111111111111
10000010100010000000000001
10s00010101110011111111111
100000101000000100000010v1
11110010001111110010001001
10000010101000000010000001
1h000010101001111111111001
10111110101001000010001001
10101000100001001000000001
10001011111101001111111111
10001010010001000000000001
10101010010011111111100001
10101010010010000000001101
10100010010010001111111001
11111110010010001000001001
10000000011111001001001111
10000000H00000001001001001
10111111111111111001000001
10000000000000000001000f01
10010101010101010101000001
11111111111111111111111111